1111111111111111
1P0C0C00C0000001
1011111111111101
10000000000000E1
1111111111111111